abort	abort
acre	acker
actual	aktuell
actually	aktuell
administration	administration
advocaat	advokat
after	after
afraid	erfreut
agent	agent
alarm	alarmieren
alert	alert
alley	allee
also	also
ambulance	ambulanz
antbear	ameisenbär
angel	angel
antiquary	antiquar
antiquarian	antiquar
antiquity	antiquität
application	applikation
arbiter	arbeiter
army	armee
art	art
artist	artist
authority	autorität
austere	auster
axe	achse
back	backe
backside	rückseite
barracks	baracke
beamer	beamer
be_blue	blau_sein
become	bekommen
befriend	befreundet_sein
behind	behindert
behold	behalten
behoof	behuf
bell	bellen
benzene	benzin
be_out_of	bestehen_aus
berate	beraten
beset	besetzen
beware	bewahren
bier	bier
billion	billion
blackboard	schwarzes_brett
blame	blamieren
blitz	blitz
bloom	blume
blow_up	aufblasen
body_bag	bodybag
boiler	boiler
bolt	schraube
bone	bein
boot	boot
borough	burg
burgh	burg
branch	branche
brave	brav
brief	brief
briefcase	briefkasten
bring_around	umbringen
bugger	bagger
bugger	baggern
bullion	bouillon
bureau	büro
bushel	büschel
bushel	busch
canteen	kantine
car	karre
carbon	karbon
career_diplomat	karrierediplomat
catcher	ringer
caucasian	kaukasier
caution	kaution
cavalier	kavalier
chalk	kalk
chance	chance
character	charakter
chef	chef
chief	chef
circle	zirkel
china	china
clang	klang
clean	klein
cling	klingen
class	klasse
clock	glocke
cloister	kloster
closet	klosett
cold	kalt
cold	kälte
compass	kompass
comrade	kamerad
concrete	konkret
concrete	konkretisiert
concurrent	konkurrent
concurrent	konkurrenz
concurrence	konkurrent
concurrence	konkurrenz
condensed_milk	kondensmilch
confession	konfession
consequently	konsequent
construct	konstruieren
control	kontrolle
copy	kopie
copyright	recht_zur_anfertigung_von_kopien
corn	korn
corpse	korps
craft	kraft
crank	krank
cranky	kränklich
cranky	kränkelnd
cranky	krank
cravat	krawatte
critic	kritik
cultivator	kultivator
cup	kopf
curious	kurios
dam	damm
deacon	dekan
deadbeat	totschlag
decent	dezent
deepfried	tiefgefroren
deer	tier
defect	defekt
delicate	delikat
detective	detektiv
dick	dick
dick	beleibt
diet	diät
director	direktor
direction	direktion
discretion	diskretion
diverse	diverse
dog	dogge
dome	dom
don´t_mention_it	erwähne_es_nicht
drug	droge
dutch	deutsch
eagle	igel
edge	ecke
effective	effektiv
elk	elch
engaged	engagiert
engineers	ingenieure
eventually	eventuell
evergreen	evergreen
evidence	evidenz
evidence	offensichtlichkeit
exactly	exakt
expertise	expertise
extravaganza	extravaganz
fabric	fabrik
faggot	fagott
familiar	familiär
fan	fan
fan	anhänger
fang	fang
fart	fahrt
fast	fast
fasten	fasten
fatal	fatal,w_mit_schlimmen_folgen
fatal	verhängnisvoll
feel_free	sich_frei_fühlen
figure	figur
figure	figur
fire_ship	feuerschiff
first	first
first	fürst
first_floor	erster_stock
floor	flor
floor	flur
flipper	flipper
foresee	vorsehen
foreswear	verschwören
forth	fort
freedom	frieden
friend	freund
friend	freundin
from	von
from	vom
fruitcake	fruchtkuchen
gang	gang
garb	garbe
gate	gasse
gemsbok	gamsbock
gemsbok	gämse
genial	genial
genie	genie
get_over	geraten
get_over	sich_begeben_über
gift	gift
glad	glatt
godfather	gottvater_vater
grill	grill
grill	grillen
grill	grill
grill	grillen
gracious	graziös
grass	marihuana
gross	groß
ground_breaking	grundbruch
guilty	gültig
gymnasium	gymnasium
half_four	halb_vier
handle	handeln
handy	handy
hardly	hart
hardhead	dickkopf
hardware	hardware
harm	harm
harvest	herbst
hateful	hasserfüllt
haversack	hafersack
heads_up	kopf_hoch
headstone	kopfstein
heaven	hafen
heck	heck
hell	hell
helm	helm
heroine	heroin
hill	hügel
holocaust	holocaust
hose	hose
hot	heiß
hound	hund
housemaster	hausmeister
however	wie_auch_immer
humanity	humanität
hut	hut
hymn	hymne
hyperbole	hyperbel
hyperbole	kegelschnittkurve
ignorance	ignoranz
impregnate	imprägnieren
impress	impressum
impression	eindruck
impression	impression
improve	improvisieren
industrious	industriell
industry	industrie
integer	integer
integer	vgl_integrität
intelligence	intelligenz
interest	interesse
interview	interview
invalid	invalide
inventory	inventar
irritate	irritieren
isolation	isolierung
island	island
joint	joint
joint	haschzigarette
junk	junker
junk	junkie
kerosene	kerosin
key	schlüssel
kind	kind
kindergarten	kindergarten
killer_game	killerspiel
knight	knecht
labor	laboratorium
lager	lager
last_straw	letzter_strohhalm
lead	lot
lecture	lektüre
lemonade	limonade
lent	lenz
liberal	liberal
lief	lieb
lifesaver	lebensretter
limo	limo
limousine	limousine
link	links
liquor	likör
live	leben
loan	lohn
locker	locker
locker	lose
look_forward	nach_vorne_sehen
luff	luv
lusty	lustig
lusty	lüstern
lusty	lustvoll
manifest	manifest
make	machen
map	mappe
marine	marine
marmalade	marmelade
marsh	der_marsch
meaning	meinung
medicinal_product	medizinprodukt
meerkat	meerkatze
melodrama	melodram
menu	menü
middle_east	mittlerer_osten
mince	minze
minute	minute
minutes	minuten
miserable	miserabel
mist	mist
misuse	missbrauch
mobbing	mobbing
molasses	molasse
momentum	das_moment
monitor	klassensprecher
monitor	klassenprimus
monitor	aufseher
monitor	beobachten
mood	mut
moonshine	mondschein
moor	moor
moose	moos
mundane	mondän
murder	mörder
must_not	muss_nicht
neck	nacken
novel	novelle
novel	novelle
in_a_nutshell	in_einer_nussschale
nun	nun
nut	nuss
offer	opfer
officer	offizier
oldtimer	oldtimer
only	nur
operation	operation
ordinary	ordinär
organ	organ
organic	organisch
orient	orient
out_of_the_question	außer_frage
out_of_the_question	zweifelsohne
outlandish	ausländisch
outlook	aussicht
over	der_binomialkoeffizient
overhead	überhaupt
overhear	überhören
overlook	überblicken
overlook	übersehen
oversee	übersehen
oversleep	überschlafen
pamphlet	pamphlet
paper	papier
paraffin	paraffin
paragraph	paragraph
parole	parole
paste	paste
pathetic	pathetisch
patient	patient
pepper	pfeffer
pepperoni	pfefferoni
pepperoni	peperoni
personal	personal
perverse	pervers
pest	pest
petroleum	petroleum
photograph	fotograf
physical	physikalisch
physician	physiker
pickle	pickel
pimpernel	pimpernell
pine	pinie
plague	plage
platform	plattform
plump	plump
pointed	gepunktet
police_officer	polizeioffizier
policy	politik
porridge	porree
portside	hafenseite
posse	posse
power	volle_power
power	vollgas
predict	predigt
pregnant	prägnant
preservative	präservativ
privateer	privatier
probe	probe
procurer	prokurist
promotion	promotion
prophylactic	prophylaxe
prophylactic	prophylaktisch
proscribe	vorschreiben
prospect	prospekt
provision	provision
psychic	psychotiker
public_viewing	public_viewing
pudding	pudding
pumps	pumps
puppy	puppe
puzzle	puzzle
quell	quelle
queue	queue
quote	quote
quote	quote
rate	rate
realise	realisieren
receipt	rezept
reclamation	reklamation
record	rekord
regal	regal
rentable	rentabel
reverend	referent
reuse	reuse
rheumy	rheumatisch
ringer	ringer
rise	reise
rise	reisen
rock	rock
rocker	rocker
roman	roman
rosewood	rosenholz
rumour	rumoren
scholar	schüler
schmuck	schmuck
scrupulous	skrupellos
sea	see
secret	sekret
selfconscious	selbstbewusst
selfsatisfaction	selbstbefriedigung
sensation	sensation
sense	sense
sensible	sensibel
sensitive	sensitiv
serious	seriös
sex	sex
shall	schall
shawl	schal
shellfish	schellfisch
siege	sieg
siege	besiegt
side	seiten
silicon	silikon
simmer	simmer
since	seit
sinus	math_sinusfunktion
siphon	siphon
site	seite
sleep_in	einschlafen
slip	slip
slip	slip
slipper	slipper
smoking	smoking
snake	schnecke
sodium	soda
sodomy	sodomie
solid	solide
spend	spenden
sphere	sphäre
spleen	spleen
spot	spot
spur	spur
stadium	stadium
stark	stark
steer	stier
stern	stern
sticky	stickig
sticky	schwül
still	still
stock	stock
stool	stuhl
strafe	strafen
strand	strand
stream	strom
string	string_tanga
student	student
stuffed_animal	ausgestopftes_tier
subject	subjekt
sublime	sublim
swear	schwören
sympathy	sympathie
tachometer	tachometer
tag	tag
tank	tank
taste	taste
technology	technologie
teller	teller
textbook	textbuch
therefore	dafür
thick	dick
tick	ticken
tide	zeit
tier	tier
tip	tipp
tits	titten
ton	tonne_im_sinne_von_fass
ton	metrische_tonne
tor	tor
total	total
tractor_trailer	trecker
tractor_trailer	traktor
trainer	trainer
trillion	trillion
troop	truppe
trouble	trubel
underarm	unterarm
undertake	unternehmen
undertaker	unternehmer
unqualified	unqualifiziert
unreconstructed	unrekonstruiert
van	van
van	kleinbus
ventilator	ventilator
vest	weste
vital	vital
wage	wiegen
wage	abwägen
wand	wand
warning	warnung
watch_over	überwachen
water_head	wasserkopf
warehouse	warenhaus
well	welle
welt	welt
wharf	werft
where	wer
whimper	wimper
who	wo
why	weil
wink	winken
wish	wischen
you_are_welcome	willkommen
zimmer	zimmer
