sprengmittel	exploder
konvulsiva	convulsants
klo	bog
degressiv	declining
kammblatthühnchen	lilytrotter
unabwendbar	unavoidable
geschwisterlich	brotherly
überbewertend	overvaluing
übertreter	violator
sowjetologie	sovietology
weberspule	quill
arterienklemme	compressor
dekohärenz	decoherence
verantwortung	charge
kernspin	mri
pesos	pesos
vomicin	vomicine
bühnenhelfer	stagehand
abkunft	parentage
hämpfling	weed
quarzstaublunge	pneumonoultramicroscopicsilicovolcanoconiosis
simbabwe	zimbabwe
aguilarit	aguilarite
lehrend	discipling
knochenende	epiphysis
septett	septet
extrakt	digest
breitseite	broadside
trampeln	trampling
tonziegel	claytile
planke	board
machnowschtschina	makhnovshchina
maskerade	masquerade
eilfertig	hastily
lageberichte	advices
avers	obverse
wirklich	substantial
dörrfleisch	jerky
polarität	polarity
orangenhaut	cellulite
reduzierung	cutback
zylindrizität	cylindricality
approximation	approximation
onyx	onyx
koerzitivfeldstärke	coercivity
sektenmitglied	sectarian
galliskiit	galliskiite
störenfriede	troublemakers
dreigeteilt	tripartite
verklagte	indictee
mitteilender	communicator
ungerächt	unavenged
hartmetall	carbide
stumm	schtum
kreuzworträtselautor	cruciverbalist
verhüllung	mantling
handleser	palmist
quaderwerk	ashlar
inneramerikanisch	domestic
waschtisch	vanity
isotopisch	isotopic
etymon	etymon
kinderärztlich	paediatric
republiken	republics
drosselgrube	jugulum
kondensat	condensate
abstellfläche	apron
apophyllit	apophyllite
antiquitäten	antiques
kumtyubeit	kumtyubeite
akrosin	acrosin
vergnüglich	amusing
gebälk	beams
lakonium	laconicum
schiedsfähig	arbitrable
verendet	died
methodenlehre	methodology
wasserpatrouille	floaters
sauertopf	sourpuss
mamlukisch	mamluk
genährt	nourished
prüfungsbetrieb	examinations
walrat	spermaceti
neuromancer	neuromancer
plätschern	burble
antipathien	antipathies
perseveration	perseveration
umarmungsmarathon	hugathon
antiperspirantien	antiperspirants
odeure	odors
biograf	biographer
flexibel	adjustable
hypergammaglobulinämie	hypergammaglobulinaemia
ausgezackt	serrated
rotfisch	huchen
besenkorn	durra
antiöstrogen	antiestrogen
vorbesitzer	prepossessor
banken	banks
steuerfeder	connector
saustark	smashing
audiologe	audiologist
blöken	bleating
yaroshevskit	yaroshevskite
romanit	romanite
rune	rune
mitsprache	voice
hoheitsrecht	regalia
kalkulieren	calculating
zugkräftig	appealing
ingestiert	ingested
aufgelauert	ambuscaded
geschummelt	cheated
schreibersit	schreibersite
überschätzend	overestimating
zuerkennend	awarding
eingespeist	injected
schwadmäher	swather
perspektive	aspect
messsender	wobbulator
ciprofloxacin	ciprofloxacin
ausgestrahlt	aired
kalderasch	kalderash
zinkat	zincate
grobschlächtig	coarse
tvedalit	tvedalite
nisin	nisin
fotobuch	photobook
grasen	browse
akademien	academies
datei	file
übergabevariable	parameter
krümelnd	crumbing
nichtverfügbarkeit	unavailability
sakrospinal	sacrospinal
krautsalat	coleslaw
steuerzahler	taxpayer
verlottert	dissolute
gynäkologika	gynecologicals
neyit	neyite
justiziabilität	justiciability
mesotendineum	mesotendineum
kräder	motorcycles
selbstgefällig	priggish
gegenüberstehend	facing
doldenrispe	corymb
phryger	phrygian
telebanking	telebanking
gemeinden	churches
misston	contretemps
geschwindigkeiten	celerities
aufenthalte	stays
mallinie	tryline
verbracht	spent
gouvernement	governorate
drossel	choke
luftwaffenbasis	airbase
heilbarkeit	curability
entscheidungen	arbitrations
kraftvoll	forceful
unabschließbarkeit	interminability
antitheismus	antitheism
plumbum	plumbum
forderungspfändung	garnishment
dekaeder	decahedron
flutgewässer	floodwaters
befestigungsmittel	fastener
hops	hop
schlachtkalb	vealer
phlebektomie	phlebectomy
unbeschnitten	uncircumcised
aphon	aphonic
krafträder	motorcycles
urethrographie	urethrography
cefaclor	cefaclor
atomzahl	atomicity
fälligstellung	repayment
acholi	acholi
uferschnecke	periwinkle
homorgan	homorganic
kraftfahrer	motorist
collection	collection
instrument	appliance
belladonna	belladonna
isoprenylierung	isoprenylation
losgelöst	detached
zornigkeit	wrathfulness
psychagogisch	psychagogic
zwitschernd	chirping
rackerei	grind
jagiellonen	jagiellons
riechtentakel	rhinophore
profundeste	profoundest
lagerfähigkeit	storability
zahnstocher	pick
gebildete	intelligentsia
tunnelbauer	tunneler
zapfhahn	crane
hypoaktivität	hypoactivity
seitdem	since
endokarp	endocarp
gedicht	ode
gebelle	latration
auktionsraum	saleroom
tusch	fanfare
schmeicheleien	blandishments
westerveldit	westerveldite
briese	sweetbreads
mord	hospiticide
seitenrand	margin
trinukleotide	trinucleotides
kolibri	colibri
mpororoit	mpororoite
zwergbarsche	dottybacks
pakistaner	pakistani
gigajoule	gigajoule
gezanke	bickering
ausgereist	left
durchweichtsein	soddenness
rinkit	rinkite
überrock	overskirt
lederartig	coriaceous
kader	pool
pommern	pomerania
unterbauten	bases
vertragspartner	affiliate
tadellos	immaculate
treugeber	truster
baschkiren	bashkirs
ikonologie	iconology
luftreifen	pneumatics
biberhut	beaver
liedtexter	songwriter
myronsalbung	chrismation
litauisch	lithuanian
bühnenmäßig	stagy
dachstroh	thatch
götterdämmerung	ragnarök
minilaparotomie	minilaparotomy
anxiolyse	anxiolysis
entmutigung	damp
positiv	positive
belegungsplan	layout
essenzialistisch	essentialist
sondenernährung	gavage
sollzinsen	interest
damenschneiderei	couture
borstenförmig	setiform
gondeln	gondolas
erdverlegt	buried
deontologie	deontology
gestrandet	aground
plateaus	plateaus
lycorin	lycorine
eusebianer	eusebians
gerechtigkeiten	equitableness
kreatürlich	natural
hi!	hi!
vernichtet	annihilated
schnupftuch	handkerchief
sonographie	sonography
ritual	ritual
ausgräberin	excavator
topographen	topographers
pilzkundlerin	mycologist
lymphgefäße	lymphatics
weinernten	vintages
salpingoskop	salpingoscope
zurückgehend	outgoing
feuerleger	firebug
doppelhaus	duplex
bolognesin	bolognese
schulterlos	shoulderless
gickel	cockerel
desperation	desperation
chadwickit	chadwickite
chili	chile
schmackhaft	flavorful
parkiert	parked
berufstätig	active
infantin	infanta
aufgezwungen	forced
prägend	coining
ghule	ghouls
vorpositionierung	prepositioning
lärmer	roisterer
impressionabel	impressionable
properhandel	dealings
lithiotantit	lithiotantite
verkabelnd	wiring
titrierend	titrating
pestbeule	bubo
abtwürde	abbacy
harnstoff	urea
kanäle	canals
sabayon	sabayon
clathrate	clathrates
introspektion	introspection
hungerleider	starveling
drangsal	distress
